######################################################
#....................................................#
#....................................................#
#....................................................#
#....................................................#
#....................................................#
#.......................##...##......................#
#.......................#.....#......................#
#..........................@.........................#
#.......................#.....#......................#
#.......................##...##......................#
#....................................................#
#....................................................#
#....................................................#
#....................................................#
#....................................................#
#....................................................#
######################################################
