######################################################
#....................................................#
#................M...................................#
#....................................................#
#....................................................#
#....................................................#
#.......................##...##......................#
#.......................#.....#......................#
#..........................@................M........#
#........M..............#.....#......................#
#.......................##...##......................#
#....................................................#
#....................................................#
#....................................................#
#........................................M...........#
#....................................................#
#....................................................#
######################################################
